about : hakkinda
above : ustunde
across : karsisinda
act : hareket
action : aksiyon
actually : aslinda
add : eklemek
addition : ek olarak
adjective : sifat
afraid : korkmus
africa : afrika
after : sonra
again : yeniden
against : karsisinda
age : yas
ago : once
agreed : anlasildi
ahead : onunde
air : hava
all : hepsi
allow : izin vermek
almost : neredeyse
alone : yalniz
along : boyunca
already : zaten
also : ayrica
although : ragmen
always : her zaman
baby : bebek
back : arka
bad : kotu
ball : top
bank : banka
base : temel
be : olmak
bear : ayi
beat : yenmek
beautiful : guzel
became : olmak
because : cunku
become : olmak
bed : yatak
been : olmak
before : once
began : baslamak 
begin : baslamak
behind : arka
being : olmak
believe : inanmak
bell : zil
belong : ait olmak
below : altinda
call : aramak
came : geldi
can : yapabilmek
cannot : yapamamak
canâ€™t : yapamamak
capital : baskent
captain : yuzbasi
car : araba
care : onemsemek
carefully : dikkatlice
carry : tasimak
case : dava
cat : kedi
catch : yakalamak
cattle : inek
caught : yakalamak 
cause : sebep
cell : hucre
center : merkez
cent : sent
century : yuzyil
certain : kesin
chance : sans
change : degismek
chart : tablo
check : kontrol etmek
chief : sef
child : cocuk
dance : dans etmek
dark : karanlik
day : gun
dead : olu
deal : anlasma
death : olum
decide : karar vermek
decimal : ondalik
deep : derin
describe : aciklamak
desert : col
design : tasarim
details : ayrintilar
determine : belirlemek
develope : gelistirmek
dictionary : sozluk
died : oldu
difference : fark
different : farkli
difficult : zor
direct : direkt
direction : yon
discover : kesfetmek
distance : mesafe
divided : bolunmus
division : bolum
do : yapmak
doctor : doktor
each : her biri
early : erken
ear : kulak
earth : toprak
east : dogu
easy : kolay
eat : yemek
edge : kenar
effect : etki
egg : yumurta
eight : sekiz
either : ikisi de
electric : elektrik
element : element
else : diger
end : son
energy : enerji
engine : motor
england : ingiltere
english : ingiliz
enjoy : eglenmek
enough : yeterli
enter : girmek
entire : tum
equal : esit
equation : denklem
especially : ozellikle
lake : gol
land : arazi
language : dil
large : genis
last : son
later : sonra
laugh : gulmek
law : kanun
lay : uzanmak
lead : kursun
learn : ogrenmek
least : en azi
leave : terketmek
led : onderlik etmek 
left : sol
leg : ayak
length : uzunluk
less : az
let : izin vermek
machine : makine
made : yapilmis
main : ana
major : major
make : yapmak
man : erkek
many : cok
map : harita
march : mart
mark : isaret
match : mac
material : materyal
matter : madde
may : belki
maybe : belki
me : ben
mean : anlam
measure : olcu
meat : et
meet : tanismak
melody : melodi
member : uye
men : erkekler
metal : metal
method : metot